┌────────────────┐
│_               │
│ \___     ___   │
│     \___/   \  │
│           .  | │
│  .           | │
│         .:   | │
│     ..       | │
│ _           /  │
│/ \_   .  __/   │
│    \____/      │
└────────────────┘

##################
a                #
a                #
a                #
a                #
a                #
a                #
a                #
a                #
a                #
a                #
##################

a: Transition;Area_2_6;X:16
