+----------------+
|/\/___\-/__\ /\ |
|^ \|     |^ /__\|
| \_\  .  /_\---/|
|  \| .       :  |
| ^_\    .       |
|/ \|        .   |
|   \-/\-+       |
|\/\_\__\|  .   .|
|/  \ /\ +-------|
|____/__\        |
+----------------+

##################
##################
####      ########
####      ########
####             a
####             a
####             a
####             a
#######          a
#######          #
#######          #
##################

a: Transition;Area_1_4;X:1
