┌────────────────┐
│================│
│  /\+----+ /\  ^│
│\/  \    |^__\/ │
│ \/\_\   /_\-/__│
│_/  \           │
│/____\   .  :.  │
│ /\ |           │
│/  \+^-+  .   /\│
│  ^ / \|     /  │
│ / \___\----/___│
└────────────────┘

##################
##################
#####       ######
######     #######
#######   ### ####
######           a
#######          a
####             a
##### #        ###
########      ####
#########    #####
##################

a: Transition;Area_3_9;X:1
