+----------------+
|    |   |    H  |
|   H|           |
|    |   | H     |
|   H    |     H |
|    |   +-  --  |
|   H          | |
|    |         | |
|    |         | |
|    +- -+  +--+ |
|     H  |  |  H |
+----------------+

##################
#             #  #
#   #            #
#          #     #
#   #          # #
#                #
#   #            #
#                #
#                #
#                #
#     #        # #
#aa#aa#a#aaaaaa#a#

a: Transition;City_3_2;Y:1
