┌────────────────┐
│█▀▀▀▀▀▀▀▀▀▀▀▀▀▀█│
│█              █│
│█▓▓▓▓▓▓▓       █│
│█      ▓        │
│█  ╔╗  ▓        │
│█  ╚╝  ▓        │
│█      ▓        │
│█▓▓▓▓▓▓▓       █│
│█              █│
│█▄▄▄▄▄▄▄▄▄▄▄▄▄▄█│
└────────────────┘

##################
##################
##              ##
##              ##
##               a
##  ee           a
##  ee           a
##               a
##              ##
##              ##
##################
##################

a: Transition;Dung_3_8;X:1
e: Exit
